NO ./path_to_the_north_texture
SO ./path_to_the_south_texture
WE ./path_to_the_west_texture

EA ./path_to_the_east_texture

F 220,100,0

C 100      ,   10, 255




11111111111111111111111111
10000000001100000000000011
10110000011100000000000011
10010000000000000000000011
11111111101100000111000001
10000000001100000111011111
11110111111111011100000011
1111D111111111011101010011
11000000110101011100000011
1000N00000000000D000000011
10000000000000001100000011
1000N000001111001100000011
1000000000D000001100000011
10000000001111001100000011
10000000000000001100000011
1000001000000000D000000011
10000000000000001100000011
11111111111111111111111111