NO ./assets/d.xpm
SO ./assets/d.xpm
WE ./assets/ddd.xpm
EA ./assets/dddd.xpm

F 8, 41, 1
C 0, 31, 82

11111111111
10000000001       1111111111111     111111111111  11111111111111
1N000000001       1000000000001     100000000001  10000000000001
11111110001       1000000000001     100000000001  10000000000001
      10001       1111111110001     111111110001  11111111000001
      10001               10001            10001         1000001
      10001       1111111110001111111111111100011111111111000001
      10001       100000000000D0000000000000000D0000000000000001
      10001       1000000000001000000000000000010000000000000001
      10001       1111111110001111111111111100011111111111000001
      10001               10001            10001         1000001
    111000111111111111111110001     111111110001         1000001
    10000000D000000000000000001     100000000001         1000001
    100000001000000000000000001     100000000001         1000001
    111111111111111111111111111     111111111111         1111111