NO ./assets/d.xpm
SO ./assets/d.xpm
WE ./assets/ddd.xpm
EA ./assets/dddd.xpm

F 8, 41, 1
C 0, 31, 82

111111111111   1111111111111 1111111111111 11111111111111
100000000001   1000000000001 1000000000001 10000000000001
111111110001   1111111110001 1111111110001 11111111110001
       10001           10001         10001          10001
       10001   1111111110001 1111111100011          10001
       10001   1000000000001 1000000000001          10001
       10001   1111111110001 1111111110011          10001
       10001           10001         10001          10001
     111000111 1111111110001 1111111100001          10001
     100000001 1000000000001 1000000000001          10001
     111011111 1111111011111 1111111011111          11011
11111111D1111111111111D1111111111111D11111111111111111D11
1N0000000000000000000000000000000000000000000000000000001
111111111111111111111111111111111111111111111111111111111