NO ./assets/d.xpm
SO ./assets/wall3.xpm
WE ./assets/ddd.xpm
EA ./assets/dddds.xpm

F 8, 41, 0
C 0, 31, 82

11111111111111111111111111
10000000001100000000000011
10110000011100000000000011
10010000000000000000000011
11111111101100000111000001
10000000001100000111011111
11110111111111011100000011
11110111111111011101010011
11000000110101011100000011
10000000000000001100000011
10000000000000001100000011
10000000000000001100000011
10000000000000001100000011
10000000000000001100000011
10000000000000001100000011
10000000000000001100000011
10000000000000001100000011
10000000000000001100000011
10000000000000001100000011
10000000000000001100000011
10000000000000001100000011
10000000000000001100000011
10000000000000001100000011
10000000000000001100000011
10000000000000001100000011
10000000000000001100000001
10000001110101011111010001
11110111 111N10101 1111001
11111111 111111111 1111111
