NO ./assets/d.xpm
SO ./assets/wall.xpm
WE ./assets/ddd.xpm
EA ./assets/dddd.xpm

F 8, 41, 1
C 0, 31, 82


111111111111111111111
101000000010000000001                         111111111111111111111
101110101111111101111      111111111111111    100000000000000000001
100010100010000000001      100000N00000001    111000000000001111111
1110111110100000000011111111000000000000011111100111D11111D11111111
10000000000000000000D0000000000000010000000000000000000000000000011
1011111111111111011111111111000000000000000000000000000000000000001
100010100010000000001      1000000000000011111100010000010000000001
111010101011111111011      111111111111111    111110001011111111111
100000000000000000011                         100000000000000000011
111111111111111111111                         111111111111111111111
