NO ./assets/d.xpm
SO ./assets/d.xpm
WE ./assets/ddd.xpm
EA ./assets/dddd.xpm

F 8, 41, 1
C 0, 31, 82

111111111111111111111
101N00000010000000001
1011101011111111D1111
100010100010000000001
111011111010000000001
1000000000D0000000001
1011111111111111D1111
100010100010000000001
111010101011111111011
1000000000D0000000011
111111111111111111111