NO ./assets/d.xpm
SO ./assets/dd.xpm
WE ./assets/ddd.xpm
EA ./assets/dddd.xpm

F 8, 41, 1
C 0, 31, 82

111111111111111111111
101E00000010000000001
101110101111111101111
100010100010000000001
111011111010000000001
100000000000000000001
101111111111111101111
100010100010000000001
111010101011111111011
100000000000000000011
111111111111111111111